+-----------+------------------------------------+
|           |                                    |
| (closet)  |         (kitchen)                  |
|         P |                            S       |
+--------------------------+---------------------+
                           |  (balcony)          |
                           |                 P   |
                           +---------------------+